0 0 
100 140 
48 67 
70 135 
93 44 
45 139 
49 25 
61 104 
81 131 
59 106 
1101011011110111111000010001111111010010a1111111111011111111011a1011001111111101100aaaaaaaaaaaaaaaaaaaaaaaaaaaaaaaaaaaaaaaaa111101111110100101011101111101a11101
1001101111101111011111101110111110101010a0101001101111110111011a1101111011111111111a100010110111011110111111101101110001001a111111111100111011101001110111a01101
1111111111111011011011111101111111111111a1110111011111110100110a1111111110111010110a101111111111010010111011101111111110101a111011011111110111111111111111a11010
1111111011110110111111110010111101111111a1010011111101111111111a1110011111001110111a110110011111111111001010110110111111111a111010111100111101111111111111a10110
0011111001111111110110111001101110111111a1011111111101111111011a1111110111111011111a111011101101111101111011111111111010111a110111111011101111101111110111a11111
1111111111100111111111101111001111101111a1111111011101111100101a0111011111111001111a111111110111110101101111111101101111111a111111111110111011111011111111a11110
1111111111011111111101110111111111110111a1111111110001101111110a1101111111111111111a001111111110111111111011010011111111111a110100111101111111001111100110a00011
1011000011111101011101011111101111111110a1111101111111011111111a1111111111110111110a110011101111011111111111011010011101001a111111101111111110101111111110a11101
1110010111111111011110111111100111011101a1110101111110011111111a1110011011101110101a111001111101101101111110111111111111011a111111011011111011111111011011a01111
1101111111110111111101111010111111110111a1111110111111110111111a1101101101011111001a111111011110101100111011101110111111111a101101111111110111111011011101a10111
0111101101111101111111111111111110111111a1111111101101111011110a0111110111111111111a111011110111011011111111100011111111111a100111110111111101111111011111a11111
1111111111111111110001111110101011101111a1111110110111111111111a0110110111111111111a111111011011010111111110111110111111011a100111111111011111011011110111a11111
1100000010011110111110111101111110110111a1110110111011111110111a1111111111111010111a111111111111111111111111111111010111111a111101011101111111100011111111a01111
1011011111101110101011111111111010011110a1001111110111111111111a0111010111110111111a111111101011111011011111111111111111110a111101111100011001111110110010a10111
1111111110001011111110111101110111111110a1111110111101111111111a0111111111111011111a111101011111111010111111011111011100111a101111111001111011111111111111a11001
1111110111111111101101100111111110111111a1011111011111101111111a1110111111001111110a110111110011111111111011111011101111111a011011111110111110101011011111a11111
1111111011111111111111111111001010111111a1111111111001011111111a1101111011111101101a101111111011011011110001111110111011111a111110101101111101111111011101a11111
0111110101110100111110111011110101111111a1111111110111111111111a1011001111111111111a111101111011111111111111111110111001101a111011111011111111110111111111a11111
1010111001101111111101110101111111011111a1111111111111111111010a0111111111111100110a001110110110111011111111111110111111011a111111001111111111011101011111a11110
1011101111111010111111100111110111111111a1011110111010110111111a1101110110111110101a110110011111111111001101111111111111111a111010110111111101111111010111a11011
1110101111111101101111011101111011111101a0111111101111100111111a0111011011011101100a111110011101111111011111111101011011111a1010111110aaaaaaaaaaaaaaaaaaaaa11011
1111101111101001111101111101111111111101a1111100111111111111111a1111111011110111000a101110111101111111111101111111111111111a1101111110a1111110111111110111111111
1111100101101111011111111111111110111111a1111110111000111010110a1111111111101111111a111111110110110111011101111110111110111a1101010111a0111111111111111111110101
1101111111101101011101111101101001111011a1100100111101111111111a1111111101110111111a111111011111111111011001111011101111111a1111110101a0101110111111111111111110
1111110101100111011111101010010110111111a1110111111011111110001a1011011111111111111a111100011011111011111111111011000111111a1011001111a1111111111101111110111111
0111100110111111111110100110111110111010a1110110111111110011111a1111111010111101111a111011111111010010010111110001110111111a1111111111a1111111101101111111101011
0111111101111001111100111100011111100111a1110110111111111111111a1101101110111111110a111101111001111011110110111101111111110a1111111111a0110011111110101110111111
1111110110011101111110011111011111000100a0111011111111111110111a1100011110111111101a111110111111111011111111101111101110111a0111111111a1111111111111110111111110
1011111111100111110111111111110111111101a1010111111111111011010a1111101111101111101a100110111001101011110111110110101111011a1010101111a0111111011111101101111111
1100111010111011110110110111111111111100a1101111011011101111101a1001011101110110101a110111101111111111110101111101101111011a0111101101a0111000111101110101110111
0111101111111011111111111011111111111111a1111101110111110011111a1111111111111111110a111101100111101011011111011111111011111a1221022121b1112110111212022112112100
1010102002110111110011010011011101111111a1110111111011111111111a0011000111010111111a111011111111111101111111011011111111101a2022122202a0212101121220202011202111
2122222112101111111111001110110111111111a1100111111111111111100a0111111000001011111a101111111111101111111111101100111111011a1120212001b0221201222202011220111112
1221121121111011111111101111111111011111a1111011101112200221212a1121121112121221101a211012110221121111110111101010111111100a1112221212a1211102210121121111121111
0221120012122112212121110102111010120112a1011012111222021220121a2100211212022021112a211001022021121110111111011111100111011a1022222202a0212011102122221201201212
2110110102222212221211212120121022220111b1011121020221022121002a2212012202121112221a111212201211211111001111111111011110111a2011210201a2012112111221201122211112
1101211012112021012100221221222000111222a1111210211210222212101a0111022111211011111b111102011202101111111110111111101010111a2100021121a2221212012122101211022221
2102221101110222121200011122211121120110a2111102211222222022221a0101011121222212212b121221121111101011101001111111111111111a2121000112a1121102122222020222212202
0112212111122220020210212111112120220021b2121001121020022112011b2101021012212211202a010211212112021110011001111111111111111a1122122201b0112222121120012022011221
2122222022021001002102212112001221221122b0110211212102020210211b2212102121201112112b022121122211001011111111111011010111111a1211011100b1021112120202220002202210
1212020221211222112112201012212022100201b2220100122221211121021a1210221222221222022abbbbbaabbabaaaaaaaaa1101111101101101011a1022221111b2111012112012220021201122
2110212110012101211210121122120220102222b0222220122021221222112a1102221201201000221a1220200222220211111a1011011111101011010a0101222012b2120102111212011110201112
1112221021112200221101110022121122112020a1122121222022220011112a0211120220222001122a2210121210022111111a0111111011111111111a2110102122a0211212212221211102122202
1212102120121110111121220012122222222000b1221112121002220210112b1111001122122022012b0120211121211011011a1101111111111111110a2111112121a2201201122122212210012021
1012122112122222111122111112100210222221b2112221100121212220122b1211121100022111012a0012101022122212121a1001211121210201011b0221022020a1202010202001111110010121
1021122002212022211222121112011212211100b1111211122222021221221b2110122120212111121b2220121020212221210b1212112122022211120b1212220222a1201222111111212222221220
2120111210210212212212211210212020001112a0222212121121210120211b2202101221002102001a2020122212020202121b2122122200020022220a2220202201b2001201212201011110002201
0100111022210110012112201211020122202012a1212112120220221222211a1222112220211111002a2121102220222221001b1212222202222112022a1212222022b2221122112122000121022111
1201022211222102222011122201200001111100b1212101011022222121211a1210201011012120222b1222012222222022222b2212022222222222122a2220122222b1212202110122002112101222
1011120020001120212110121022111110212202b2102221211102222212110a1102110022012111121b2221112222222202100b1222201222020112221a1002222222b0021021222211012111111211
1012202022202222121110111210212211011002a2222111211110222220112b0201021121221111011b0110120022222222120b2120220222212002222b2220212002b2222021100012110212020112
0120221102121202221102120120010122111021a2200012102222111212002a0122221111201021020a1222122212112211221b0122202222210222220b2002122222b2101021201101110201221012
1212012211121112122021202222111122002012a1022212111210222010121a1211210222112121110a1200120222222201020a2220222202212212222b2022202222b2201122220222021012012211
2112222121122122011211101021200211212111a1121001120122222122222b2021211201101100021b0010122222000021022b2020222022222220202b2220002222b2122220120122221211122222
2102121021200121220222022021021002112210a0111210222220021012210b1112212011211112210b0210121002202012102b0221011221222222002b1202022220b0002120111220110121122222
1222111220220011002122101221021121111220b0021212122122001122002b0211022202021210122a2211212222222212222a2121220222221122122a2022202000b2122112102202202221222221
2202202212220211220222121022221022120102b1221120120001211221221a1222020010202212100b2222202202212212202b1021022222202210202b2222220220b2210212022220212022112122
2222120120212110212210002220121120220210a2022221001011212121110a1101211112211101201b2222122202222222212b2120102202221222012b2222202102a2200222000210200101221022
1211022111102121211101110121011221111121a0022212221122021012220b1221021222102122012b2101222222222202221a2022122022111121222b2020222202b0020221221220222211021221
1022120200221212102212022112100212212220b2000102222022122212122b2001111221012101020a2111021220222212222a2122221222022222222b2222222221b1211120022222200212122212
0022022110111222120222202111022111212100a1011122121021222211201b2222222122100111102aaaababbbbbbbbbbaaabb2122222021121120222b2220002222bbbbabbbbabbbbbbbbbbb02121
2222122010101022012102022222212211211110b1111200111221222020020b11122112002202221122021112212222222112212222211012222002210b222221122222222121221212202222b12212
2010210102212221211222110221001122202210b2121102211002121102212a01101212110000111210221112222220210212122002222102210220022b200222122022021222202222222222b02120
2220002021221011222121111110021121211112a2221112021222210122102a11122011222222122020212120222220221221212220120220021010222b222022222220200022222222220202b12122
2222221201222020221221111222112222220202b2212122221222202001211a02011110121221122111001100201022222220202222010201020201202b212202222222221222222222002202b22202
2202221111212020112111021111021012211001a0021111110001021112011b01122220212222121101202202220201202212200202020012121102122b220122222202222202122222202020b22211
0222222122102010022112211202210020020011b1012012210222022112212b22220202221212221121011022220202200022022212222122022221222b220202022222221002222021222212b21202
2022211012122221120122222222222212122211b1200201200212021010112b12100020220011122000221122020211221221112222212212220222222b202222202122222022222221221222b22222
0221222222102010120120021212012222111222b2221121111020102211112b02021212101222022201121100222002222201011220202002211102220b222020222222221020222220222222b11212
2202222220210102110122222002121010220022b1121122022222220022212a21122121222102101121020022022100220221222201012022222222222b222022022022022222011212122222b11222
bbbbbbbaababaaabbbbababaabbababbbaababaab1122022211110222211112b22112112022112121222210122120220222102200001112211121222222b222002000220220222200102222222b20222
122020121112220010010222112112222110121222212102111222221112220b20121211021222201111121212200202002221222220222222122202202b002222022202122122010222122222b22222
021222202112221112202220101011221222011111021202102022022022111a22121211101111222111111122222222222222221122222012020202222b202222222220222221202222222222a22212
220212000011212220101120121211021111002111101020222221121021001b21211222212212212212101211220222120222222220220112122102222b200220222202022202222001202200b20200
221222221111120221111201201220010212202212120210200112122200120b11110211120212222200121112102222222202112222201222222122220b222202222020202220212002122102b20202
202222112210122212121211111211122010222212120110120122211211222b12222102021212221211011000202210201211122121210222221022222a012202022222222222020222220212a21222
221122101212211211022010222122221212201011211200121212220002110a21100202022121222211101102021202212210222222020220222222222b122202222202200020000102212200a22222
202210011111121122012121120222222121222211121121021102110121220a11212221221210110211202120122222202212222222222202210221222b122202220221222022221201122020a20002
222020011121112121222111212221221222002201220102122221021121222a00011022212200221202011111122222202022212222221220210122200b020202220200222021222202222222b20122
221101110111120101220111001210022222022212101211212220221112121a12102202112101111100111011222002021202202222222121002220220a002222222222212220221210212202b20202
120222111111100110010011111110101212121012210012222021012220101ababbaabaabaaaaaaaaaaaaaaaaabbababbbbbbbbbabbabbbbbaabbbbbbbb222022221200222222102202202200b10222
2020121011101010111111001111101122212101121112201112112110112011112210202121110111111111121102202112222021220122222202022220202202222222210201202202222221b12212
1201011110011111101011000111110022000221101011111212222102122021201001101121110111101111110122202222222222022220202222222222222221022222222122102212220111b20012
0221110111001011111101101011102100112211221211001022122112220010210002112121111110111010112222202222222220212222212102020222220222222222212211222222202212a02220
1110021111111111101110101101021020211211220121221212211120102202121122211211111101111001112220212200222222012222222222120022212222222221122211212011122022a11222
2220111110101110111010001011121210121121000112210222202222221222021122121101101101100111111212222120222121212021222222022021002222222002221022222210020201b20002
2202120110111111111110111111111020222112101222210110211212210000121200222020011110110101111022220012220222222220000222212100022222202222210212002212011002b22201
2021201111000111111111111111012011101012022111212222022211221221110120212211110011101110111102212221221211222222222222222122212221222222222100022202120222b22020
1221011101011111111111111111112222211100211101211221222202122112221012101111111111111111000211200222022220102202202220222220222222222202222022120222022101a02221
2202111111011110111111111110021210021102212111201121221111121001011022212201101111111010111121220110020122222222122022212222201222222202222022221112220220a20011
0200001111111011100111101111120101221000221121201202101111212222210120001200111111111101121112121222101212200221001102212222200120220222122212102222222212b22220
2221201111110110110111110110121111121011222121112212221221011210012121200121111011101111111120111222110211210212222222020212222222212202000222222222012122b22222
1011121011011101111100111111122201222211110221122220111111220212111211021221111110111111111101110111111111111111111111122222022001222212211202202012200222b22221
2022221111111101011100111100112112121210112122011101101202022122021211112020011111110110111111111101111111111011101011122202011222222002001102122220101200a21202
2222201110111111101110011110120220212111110121101201121110202222010211102221111111011111011001110111111111011101111020222121220011122012102202221122001002b02220
2021121111111111101011101011112022222012212012001200211112012011110112222010110111110111111111110111101111111100110022121120202111122222122021221222221212b21202
2110111110111011011011110111010111212210121222211100210211211022212010210221101111110111011101111011101101101111111122210122222012102211022220220222220200b20222
1220211011101111011101111100112010211101012110122221120211001101101120122201101111011001111111111111011111111101011121212221221122220020022220122222121101a00122
2210221111010110111111110001021210122220202210110001201221202111011222210221111110111111111111011001111111111101110011220112210201022222202222220022020210b00222
2122001101111100111111101111122201112012001122102112111122102121212122122111101110111111111111111111011111111111101012020112202222022020222222221121221220b12212
0010020111111011111110001011102221022122212112020122002110221021101022021011111011111110111100111110111111101101111111021212102222021220202201022222221221a11210
1212120110111111111101111110121201221021012222210112222121112222221121211211111011110111111101111111111111111111111021112201110200221212121222020021021122b02221
2211111111011111111111111011011212120111111202111120101112112222212221012220111111111000111110110111001111111011111112111222212121122021022012121101122202b11100
1211110101111111110111001111102121200221210211012221001222000212022202222121110100101111110111111111111011010111110112220211112202100112222112121222212000a11222
2011111110111110111100111011011122212122221211112210121202211211122121101211111111011111111101111111111011110111101112221102222222121211221222011100101210a22022
0211111110010101111111111110101122211211222222221020120011101110212100221111111111101011111101111011101101111101110111212220001120120210101111222111111102b02220
0201110111111111001101011111121220121120211122012102220220122121112211002121111111111111111111111111110111111111111111121021111220211200210212012212121211b22112
aaaaaaaaaaaaaaaaaaaaaaaaaaaaabbabaabbbabaaaaaababaababaaaababbbaaabbbabbaaaaaaaaaaaaaaaaaaaaaaaaaaaaa10001111111111000122212001211111211122212222202101110a21122
2101011010001111100111111011102010022122111122211222202022222212122221220121111110111111110111010101a01100111111110012211211020212222122020212221211011201a21202
2211111111011111111111110110121212111011122011112020200122101121111111121021110011011101111111101111a11011110111111011101102000120122202222121220211121001a20022
1111111100101111011111011111011021112211221102220212222001001212212211220010101001111111111111111111a11101111011111121112020222000210021221211102211212122a20211
2211101111101111011110010011012222112212022222222221202201021210221210210101000111110011111111110111a11101111110111111121111222011010200212222221212010101a01212
1211001010011010111110111111111221210002202021200202211122222021121111210110111100111001111011110111a11101111111111110001111010110111111111111111111111111a11001
1111111110111111111001110101020110211012022221202121222202221121122020221221100001110111111011110000a11011101100110111110001011111111111110111011111110111a11101
1111101111111100010111001101112111202210021102121222112121021122222211110121001110100111101111101111a11111111111111111010001101011111111101001111111101101a11101
1001111100110110011010011110112222011110022112102222112120222212022111022220111111110110011111110111a01111011111110011011110111110110111110111011111111111a10111
1011111111101001101101111111112221002222202121210221222211110121202020222201111111111110111111111111a01111111111101111110111111111111111111111111011011111a11011
1111111111011011111101011111111212220111120121011101010022111101100202201121111111011011001111110111a01111111001011011111111101111110111001111111111111110a11111
1110101110100111101111111111110120221011221211222210012012202120201202102101011111011101111100110110a11101111010111110111111101111111111111111111101110111a11111
1111111001010110011111011111111122202100211011211022202222202121101121122211101111111110111011111100a11110110101111000111111111111111111111101111000111111a11011
